11111111111111111111111111111111111111111111111111111111111111111111111111111111
001111111100011100000001111111000000000000+111+000000000000111100000000001000011
10111111110111111110111111111111111101111111111111110111111111101111111111011111
10000000000000000000000000000000000000000000000000000000000000000000000000000001
10111111110111111110111111111111111101111111111111110111111111101111111111011101
10111111110001110000000111111100000000000001110*00000000000111100000000001000101
11111111111111111111111111111111111111111111111111111111111111111111111111111101
10111111110001110000000111111100+00000000001110000000000000111100000000001000101
10111111110111111110111111111111111101111111111111110111111111101111111111011101
10000000000000000000000000000000000000000000000000000000000000000000000000000001
10111111110111111110111111111111111101111111111111110111111111101111111111011111
10111111110001110000000111111100000000$00001110000000000000111100000000001000111
10111111111111111111111111111111111111111111111111111111111111111111111111111111
10111111110001110*00000111111100000$00000001110*00000000000111100000000001000011
1011111111*111111110111111111111111101111111111111110111111111101111111111011111
10000000000000000000000000000000000000000000000000000000000000000000000000000001
101111111101111111101111111111111111*111111111111111*111111111101111111111011101
1011111111000111000000011111110000000000000111000000000000011110*000000001000101
11111111111111111111111111111111111111111111111111111111111111111111111111111101
1011111111000111+00000011111110000000000000111*0000000000001111000000000+1000101
#0111111110111111110111111111111111101111111111111110111111111101111111111011101
10000000000000000000000000000000000000000000000000000000000000000000000000000001
10111111110111111110111111111111111101111111111111110111111111101111111111011111
11111111111111111111111111111111111111111111111111111111111111111111111111111111
